11111111111111
1C111111000011
1C0000000000C1
1110P000111111
1C0000000E0001
11111111111111
