11111111111111111111111111111
1C0000000000C000C0000C0000C01
1C0000000000C000C0000000C0001
1C00P0000000C000C000C00C0C001
1C0000000C00000E00000C00C0001
11111111111111111111111111111
