111111111111
100P0000E0C1
100000000001
100000C00001
111111111111
