1111111111111111111
1011111100001000001
1000E00110000000001
11100001PCCCC000001
10000000C0000000001
10000000C0000000001
10000000C0000000001
10000000C0000000001
1111111111111111111
