1111111111111
100P0000E0001
1111111111111
