1111111111111
100P0000E0C01
1111111111111
