111111111111111111
1000000000C0000001
100000000000000001
1E000000000000P001
111111111111111111
